LOL: laugh out loud
OMG: Oh my God
ILY: I love you
LMAO: laughing my a** off
TTYN: Talk to you never
FBO: Facebook official
TTYS: Talk to you soon
HMB: Hit me back
SFW: Safe work work
PTFO: Passed the f** out
ASL: Age/Sex/Location
AFAIK: As far as I know
IMHO: In my humble opinion
IRL: In rela life
ISO: In search of
J/K: Just Kidding
L8R: Later
POV: Point of view
RBTL: Read between the lines
RT: Real time
BTW: By the way
CTN: Can’t talk now
CYE: Check your email
dI: Download
ETA: Estimated time of arrival
FWIW: For what it’s worth
FYI: For your information
GG: Good game
GJ: Good job
GL: Good luck
gr8: Great
GTG: Got to go
GMV: Got my vote
HTH: Hope this helps
OT: Off topic
PC: Personel computer
pls: Please
POS: Parent over shoulder
ppl: People
Txt: Text
BRB: Be Right Back
B4N: Bye for Now
BCNU: Be seeing you
BFF: Best Friends Forever
CYA: Cover You’re A**
TY: Thank you
w/e: Whatever
W8: Wait
XOXO: Hugs and kisses
Y: Why